NO ./TEXTURES/XPM/WALLS/BRICK_3D.xpm
SO ./TEXTURES/XPM/WALLS/CONSOLE_1B.xpm
WE ./TEXTURES/XPM/WALLS/StoneUWHitlerL.xpm
EA ./TEXTURES/XPM/WALLS/BRICK_6D.xpm

F 128,128,128
C 0,0,0

1111111111111111111
1000000000000000001
1001110000100000001
10011100001000000010000000000
10000000001111100010000000000
1000000111100000001
10000001001000000010
11100001001000S0001000
1110000000000000001
1111111111111111111