NO ./MAPS/VALID/TEXTURES/LAB_2B.xpm
SO
WE ./MAPS/VALID/TEXTURES/PIPES_1A.xpm
EA ./MAPS/VALID/TEXTURES/CONSOLE_1B.xpm

F 255,255,255
C 60,192,42

1111111111111111111
1000000000000000001
100111000010000S001
1001110000100000001
1000000000111110001
1000000111100000001
1000000100100000001
1110000100100000001
1110000000000000001
1111111111111111111